month,active,inactive,fstatus,other,total
01,1553,57,1,0,1611
02,1589,53,1,0,1643
03,1640,52,2,0,1694
04,1655,54,5,0,1714
05,1666,54,3,0,1723
06,1673,51,5,0,1729
07,1632,44,10,0,1686
08,1644,49,2,0,1695
09,1673,48,1,0,1722
10,1668,43,2,0,1713
11,1510,59,0,0,1569
12,1499,60,2,0,1561
